C 135,206,235    
F 211,211,211

WE ./textures/wall1.xpm
NO ./textures/wall2.xpm
SO ./textures/wall3.xpm
EA ./textures/wall4.xpm


11111111111111
10000000000001
10000000000001
10000000000001
10000000000001
10000000000001
1000000000N001
10000000000001
11111111111111

