F 163,208,999
C 163,208,999

NO ./textures/minecraft.xpm
SO ./textures/purplestone.xpm
WE ./textures/redbrick.xpm
EA ./textures/wood.xpm






1111
11   1 10001
1001 1 1 1 1
1001
1111