F 163,208,99
C 163,208,25


NO ./textures/minecraft.xpm
WE ./textures/redbrick.xpm
SO ./textures/purplestone.xpm
EA ./textures/wood.xpm

       



        1111111111111111111111111
        1000000000110000000000001
        1011000001110000000000001
        1001000000000000000000001
111111111011000001110000000000001
10000000001100001110111111111111
11110111111111011100000010001
111101111111111111010100100011111111
110000001101      1101011100000010001
100000000000111111000000100011111111
10000000000000001101010010001
11000001110101011111011110N0111
11110111 1110101 101111010001
11111111 1111111 111111111111



