C 135,206,235    
F 211,211,211

WE ./textures/wall1.xpm
NO ./textures/wall2.xpm
SO ./textures/wall3.xpm
EA ./textures/wall4.xpm


1111 11111
100010N11
111111111