C 135,206,235
F 75,75,75


WE ./textures/wall_hrban.xpm
NO ./textures/wall_hrban.xpm
SO ./textures/wall_hrban.xpm
EA ./textures/wall_hrban.xpm

       
1111111111111111
1000000000000001
1011110111110101
1010010100010101
1010010100010101
1011110111110101
1000000000000001
1111011111101111
1001010000100001
1011010110101111
1E00010000100001
1111111111111111






