C 135,206,235    
F 0,0,0 


WE ./textures/wood.xpm
NO ./textures/wood.xpm
SO ./textures/wood.xpm
EA ./textures/wood.xpm

       
1111111111111
1000000000001
1000000000001
1000000000001
1000000000001
100000000N001
1111111111111
