C 135,206,235    
F 211,211,211 


WE ./textures/wall1.xpm
NO ./textures/wall2.xpm
SO ./textures/wall3.xpm
EA ./textures/wall4.xpm

       
1111111111111111111
1000000001000000001
1011111101011111101
1010000101010000101
1010111101110111101
1010000000000000101
1010111111111110101
1000100010001000101
1110101011101010111
1000001010N01010001
1011101010111011101
1010000000000000101
1010111111111110101
1010100001000010101
1010111101011110101
1000000001000000001
1111111111111111111