NO fasdfads 
	F		0,0,00
         
C 163,208,255





      SO ./textures/purplestone.xpm
WE ./textures/redbrick.xpm
EA ./textures/wood.xpm
WE ./textures/redbrick.xpm

		1111111111111111111111111
		1000000000110000000000001
		1011000001110000002000001
		1001000000000000000002001
111111111011000001110000000000001
100000000011000001110111110111111
11110111111111011100000010001
11110111111111011101010010001
110000001 1101011100000010001
10002000001000001100000010001
10000000000000001101010010001
11000001110101011111011110N0111
11110111 1110101 101111010001
11111111 1111111 111111111111

 11111
1N1 101
 11111

 111
10N01
 111