F 163,208,99
C 163,208,25


WE ./textures/redbrick.xpm
NO ./textures/minecraft.xpm
SO ./textures/purplestone.xpm
EA ./textures/wood.xpm

       
1111111111111
1000000000001
1011111000101
10000010N0101
1000001000101
1000001000101
1011111111101
1010001000001
1010001000001
1010001000001
1010001111101
1000000000001
1111111111111





