C 255,255,255
F 0,0,0


WE ./textures/greystone.xpm
NO ./textures/greystone.xpm
SO ./textures/greystone.xpm
EA ./textures/greystone.xpm

       
1111111111111
1S00000000001
1011111000101
1000001000101
1000001000101
1000001000101
1011111111101
1010001000001
1010001000001
1010001000001
1010001111101
1000000000001
1111111111111





