C 135,206,235    
F 211,211,211


WE ./textures/wall1.xpm
NO ./textures/wall2.xpm
SO ./textures/wall3.xpm
EA ./textures/wall4.xpm

       
11111111111111111111
10000000001100000001
10110000011100000001
10010000000000000001
11111111101100000111
10000000001100000111
10110000011111111111
10110000011100000001
10000000000000000001
11110111110111110111
10000000000000000001
10111111101111111001
10000000001100000001
10110000011100000001
10000000000000000001
10110000011111111111
10000000000S00000001
10000000000000000001
10000000000000000001
11111111111111111111
