C 135,206,235    
F 211,211,211 


WE ./textures/wall1.xpm
NO ./textures/wall2.xpm
SO ./textures/wall3.xpm
EA ./textures/wall4.xpm

       
1111111
1000001
10000N1
1111111