F 163,208,99
C 163,208,25

NO ./textures/minecraft.xpm
SO ./textures/purplestone.xpm
WE ./textures/redbrick.xpm
EA ./textures/wood.xpm





11111
11111
111NN1
11111
